11111111111111111111111111111111111111111111111111111111111111111111
100000E0000C11111111111111111111111111111111111111111111111111111111
10000111110011111111111111111111111111111111111111111111111111111111
1P000100000011111111111111111111111111111111111111111111111111111111
11111111111111111111111111111111111111111111111111111111111111111111